{
  "name": "Dactyl Manuform (Handwired)",
  "vendorProductId": 1296105474,
  "macros": ["", "", "", "", "", "", "", "", "", "", "", "", "", "", "", ""],
  "layers": [
    [
      "KC_ESC",
      "KC_1",
      "KC_2",
      "KC_3",
      "KC_4",
      "KC_5",
      "KC_ESC",
      "KC_1",
      "KC_W",
      "KC_E",
      "KC_R",
      "KC_T",
      "KC_TAB",
      "KC_Q",
      "KC_S",
      "KC_D",
      "KC_F",
      "KC_G",
      "KC_LCTL",
      "KC_A",
      "KC_X",
      "KC_C",
      "KC_V",
      "KC_B",
      "KC_LSFT",
      "KC_Z",
      "KC_LBRC",
      "KC_RBRC",
      "KC_NO",
      "KC_NO",
      "KC_NO",
      "KC_NO",
      "KC_NO",
      "KC_SPC",
      "KC_BSPC",
      "KC_HOME",
      "KC_6",
      "KC_7",
      "KC_8",
      "MO(1)",
      "KC_LALT",
      "KC_LGUI",
      "KC_6",
      "KC_7",
      "KC_8",
      "KC_9",
      "KC_P",
      "KC_NO",
      "KC_Y",
      "KC_U",
      "KC_I",
      "KC_O",
      "KC_0",
      "KC_GRV",
      "KC_H",
      "KC_J",
      "KC_K",
      "KC_L",
      "KC_P",
      "KC_MINS",
      "KC_N",
      "KC_M",
      "KC_COMM",
      "KC_DOT",
      "KC_SCLN",
      "KC_QUOT",
      "KC_NO",
      "KC_NO",
      "KC_PPLS",
      "KC_EQL",
      "KC_SLSH",
      "KC_RSFT",
      "KC_END",
      "KC_DEL",
      "KC_ENT",
      "KC_NO",
      "KC_NO",
      "KC_NO",
      "KC_RGUI",
      "KC_RALT",
      "MO(2)",
      "KC_NO",
      "KC_NO",
      "KC_NO"
    ],
    [
      "KC_TRNS",
      "KC_TRNS",
      "KC_TRNS",
      "KC_TRNS",
      "KC_TRNS",
      "KC_TRNS",
      "KC_TRNS",
      "KC_TRNS",
      "KC_F3",
      "KC_F4",
      "KC_F5",
      "KC_F6",
      "KC_F1",
      "KC_F2",
      "S(KC_2)",
      "S(KC_3)",
      "S(KC_4)",
      "S(KC_5)",
      "KC_GRV",
      "S(KC_1)",
      "KC_TRNS",
      "KC_TRNS",
      "KC_TRNS",
      "KC_TRNS",
      "KC_TRNS",
      "KC_TRNS",
      "KC_TRNS",
      "KC_TRNS",
      "KC_TRNS",
      "KC_TRNS",
      "KC_TRNS",
      "KC_TRNS",
      "KC_TRNS",
      "KC_TRNS",
      "KC_TRNS",
      "KC_TRNS",
      "KC_TRNS",
      "KC_TRNS",
      "KC_TRNS",
      "MO(1)",
      "KC_TRNS",
      "KC_TRNS",
      "KC_TRNS",
      "KC_TRNS",
      "KC_TRNS",
      "KC_TRNS",
      "KC_TRNS",
      "KC_TRNS",
      "KC_F7",
      "KC_F8",
      "KC_F9",
      "KC_F10",
      "KC_TRNS",
      "KC_TRNS",
      "S(KC_6)",
      "S(KC_7)",
      "S(KC_8)",
      "S(KC_9)",
      "KC_F11",
      "KC_F12",
      "KC_TRNS",
      "KC_PMNS",
      "KC_PPLS",
      "S(KC_LBRC)",
      "S(KC_0)",
      "S(KC_GRV)",
      "KC_TRNS",
      "KC_TRNS",
      "KC_TRNS",
      "KC_TRNS",
      "S(KC_RBRC)",
      "S(KC_BSLS)",
      "KC_TRNS",
      "KC_TRNS",
      "KC_TRNS",
      "KC_TRNS",
      "KC_TRNS",
      "KC_TRNS",
      "KC_TRNS",
      "KC_TRNS",
      "MO(2)",
      "KC_TRNS",
      "KC_TRNS",
      "KC_TRNS"
    ],
    [
      "KC_TRNS",
      "KC_TRNS",
      "KC_TRNS",
      "KC_TRNS",
      "KC_TRNS",
      "KC_TRNS",
      "KC_TRNS",
      "KC_TRNS",
      "KC_2",
      "KC_3",
      "KC_4",
      "KC_5",
      "KC_GRV",
      "KC_1",
      "KC_F3",
      "KC_F4",
      "KC_F5",
      "KC_F6",
      "KC_F1",
      "KC_F2",
      "KC_F9",
      "KC_F10",
      "KC_F11",
      "KC_F12",
      "KC_F7",
      "KC_F8",
      "KC_TRNS",
      "KC_TRNS",
      "KC_TRNS",
      "KC_TRNS",
      "KC_TRNS",
      "KC_TRNS",
      "KC_TRNS",
      "KC_TRNS",
      "KC_TRNS",
      "KC_TRNS",
      "KC_TRNS",
      "KC_TRNS",
      "KC_TRNS",
      "MO(1)",
      "KC_TRNS",
      "KC_TRNS",
      "KC_MUTE",
      "KC_VOLD",
      "KC_VOLU",
      "KC_MPLY",
      "KC_TRNS",
      "KC_TRNS",
      "KC_6",
      "KC_7",
      "KC_8",
      "KC_9",
      "KC_MPRV",
      "KC_MNXT",
      "KC_TRNS",
      "KC_LEFT",
      "KC_DOWN",
      "KC_UP",
      "KC_0",
      "KC_TRNS",
      "KC_PPLS",
      "KC_PMNS",
      "KC_EQL",
      "KC_LBRC",
      "KC_RGHT",
      "KC_TRNS",
      "KC_TRNS",
      "KC_TRNS",
      "KC_VOLD",
      "KC_VOLU",
      "KC_RBRC",
      "KC_BSLS",
      "KC_TRNS",
      "KC_TRNS",
      "KC_TRNS",
      "KC_TRNS",
      "KC_TRNS",
      "KC_TRNS",
      "KC_TRNS",
      "KC_TRNS",
      "MO(2)",
      "KC_TRNS",
      "KC_TRNS",
      "KC_TRNS"
    ],
    [
      "KC_TRNS",
      "KC_TRNS",
      "KC_TRNS",
      "KC_TRNS",
      "KC_TRNS",
      "KC_TRNS",
      "KC_TRNS",
      "KC_TRNS",
      "KC_TRNS",
      "KC_TRNS",
      "KC_TRNS",
      "KC_TRNS",
      "KC_TRNS",
      "KC_TRNS",
      "KC_TRNS",
      "KC_TRNS",
      "KC_TRNS",
      "KC_TRNS",
      "KC_TRNS",
      "KC_TRNS",
      "KC_TRNS",
      "KC_TRNS",
      "KC_TRNS",
      "KC_TRNS",
      "KC_TRNS",
      "KC_TRNS",
      "KC_TRNS",
      "KC_TRNS",
      "KC_TRNS",
      "KC_TRNS",
      "KC_TRNS",
      "KC_TRNS",
      "KC_TRNS",
      "KC_TRNS",
      "KC_TRNS",
      "KC_TRNS",
      "KC_TRNS",
      "KC_TRNS",
      "KC_TRNS",
      "KC_TRNS",
      "KC_TRNS",
      "KC_TRNS",
      "KC_TRNS",
      "KC_TRNS",
      "KC_TRNS",
      "KC_TRNS",
      "KC_TRNS",
      "KC_TRNS",
      "KC_TRNS",
      "KC_TRNS",
      "KC_TRNS",
      "KC_TRNS",
      "KC_TRNS",
      "KC_TRNS",
      "KC_TRNS",
      "KC_TRNS",
      "KC_TRNS",
      "KC_TRNS",
      "KC_TRNS",
      "KC_TRNS",
      "KC_TRNS",
      "KC_TRNS",
      "KC_TRNS",
      "KC_TRNS",
      "KC_TRNS",
      "KC_TRNS",
      "KC_TRNS",
      "KC_TRNS",
      "KC_TRNS",
      "KC_TRNS",
      "KC_TRNS",
      "KC_TRNS",
      "KC_TRNS",
      "KC_TRNS",
      "KC_TRNS",
      "KC_TRNS",
      "KC_TRNS",
      "KC_TRNS",
      "KC_TRNS",
      "KC_TRNS",
      "KC_TRNS",
      "KC_TRNS",
      "KC_TRNS",
      "KC_TRNS"
    ]
  ],
  "encoders": []
}